####################
#.................##
#.......##...#...###
#....#...........###
#.########.....##
#...#..###.....##
#...#...#########
#.....##########
